VOLTAGE_DIFF_DISCUSS_2_Q.2t	 
VOLTAGE_DIFF_DISCUSS_2_Q.14t	the terminals are separated by a gap
VOLTAGE_DIFF_DISCUSS_2_Q.18t	The terminals are separated .
VOLTAGE_DIFF_DISCUSS_2_Q.21t	the terminals are separated by a gap
DAMAGED_BULB_EXPLAIN_2_Q.22t	 
DAMAGED_BULB_EXPLAIN_2_Q.27t	 
DAMAGED_BULB_EXPLAIN_2_Q.35t	 
DAMAGED_BULB_EXPLAIN_2_Q.36t	 
DAMAGED_BULB_EXPLAIN_2_Q.39t	 
DAMAGED_BULB_EXPLAIN_2_Q.46t	 
HYBRID_BURNED_OUT_WHY_Q3.6t	 
HYBRID_BURNED_OUT_WHY_Q3.7t	damaged bulb and the other bulb must be contained in the same path
HYBRID_BURNED_OUT_WHY_Q3.11t	If they are in the same path
HYBRID_BURNED_OUT_WHY_Q3.12t	 
HYBRID_BURNED_OUT_WHY_Q3.15t	 
VOLTAGE_DIFF_DISCUSS_1_Q.23t	the terminals are connected
VOLTAGE_DIFF_DISCUSS_1_Q.24t	The terminals are in the same state
VOLTAGE_DIFF_DISCUSS_1_Q.28t	 
VOLTAGE_DIFF_DISCUSS_1_Q.30t	 
VOLTAGE_DIFF_DISCUSS_1_Q.34t	 
VOLTAGE_DIFF_DISCUSS_1_Q.36t	the terminals are connected
BURNED_BULB_LOCATE_EXPLAIN_Q.51t	 
BURNED_BULB_LOCATE_EXPLAIN_Q.53t	 
BURNED_BULB_LOCATE_EXPLAIN_Q.59t	 
BURNED_BULB_LOCATE_EXPLAIN_Q.60t	indicates the place where the electrical state changes due to a gap
BURNED_BULB_LOCATE_EXPLAIN_Q.64t	electrical state changes
SHORT_CIRCUIT_X_Q.13t	 
SHORT_CIRCUIT_X_Q.14t	there is a short circuit
SHORT_CIRCUIT_X_Q.22t	 
SHORT_CIRCUIT_X_Q.26t	 
SHORT_CIRCUIT_X_Q.27t	 
SHORT_CIRCUIT_X_Q.28t	there is a short circuit
SHORT_CIRCUIT_X_Q.35t	 
CONDITIONS_FOR_BULB_TO_LIGHT.78t	 
CONDITIONS_FOR_BULB_TO_LIGHT.86t	 
CONDITIONS_FOR_BULB_TO_LIGHT.89t	One terminal of the bulb has to be connected to one terminal of the battery , and the other terminal of the bulb has to be connected to the different terminal of the battery .
CONDITIONS_FOR_BULB_TO_LIGHT.96t	 
CONDITIONS_FOR_BULB_TO_LIGHT.98t	 
VOLTAGE_AND_GAP_DISCUSS_Q.26t	 
VOLTAGE_AND_GAP_DISCUSS_Q.31t	 
VOLTAGE_AND_GAP_DISCUSS_Q.35t	 
VOLTAGE_AND_GAP_DISCUSS_Q.39t	the terminals are not connected
VOLTAGE_AND_GAP_DISCUSS_Q.44t	 
SWITCH_TABLE_EXPLAIN_Q3.51t	 
SWITCH_TABLE_EXPLAIN_Q3.54t	 
SWITCH_TABLE_EXPLAIN_Q3.57t	 
SWITCH_TABLE_EXPLAIN_Q3.64t	When the switch and the bulb are contained in the same path
SWITCH_TABLE_EXPLAIN_Q3.66t	 
PARALLEL_SWITCH_EXPLAIN_Q3.46t	The switch and the bulb have to be in the same path
PARALLEL_SWITCH_EXPLAIN_Q3.48t	 
PARALLEL_SWITCH_EXPLAIN_Q3.54t	If a bulb and a switch are in the same path the switch affects the bulb
PARALLEL_SWITCH_EXPLAIN_Q3.60t	If a bulb and a switch are in the same path the switch affects the bulb
PARALLEL_SWITCH_EXPLAIN_Q3.62t	If a bulb and a switch are in the same path the switch affects the bulb
VOLTAGE_DIFF_DISCUSS_2_Q.30t	the terminals are not connected or separated by a gap
VOLTAGE_DIFF_DISCUSS_2_Q.32t	The terminals are in different electrical states that means the terminals are not connected or separated by a gap
VOLTAGE_DIFF_DISCUSS_2_Q.35t	the terminals are not connected or separated by a gap
VOLTAGE_DIFF_DISCUSS_2_Q.38t	The terminals are in different electrical states
VOLTAGE_DIFF_DISCUSS_2_Q.39t	 
VOLTAGE_DIFF_DISCUSS_2_Q.40t	the terminals are not connected or separated by a gap
DAMAGED_BULB_EXPLAIN_2_Q.67t	a damaged bulb creates a gap in the circuit or there is an incomplete circuit.
DAMAGED_BULB_EXPLAIN_2_Q.69t	There is an incomplete circuit . A damaged bulb creates a gap in the circuit . There is an open path.
DAMAGED_BULB_EXPLAIN_2_Q.76t	a damaged bulb creates a gap in the circuit or there is an incomplete circuit.
HYBRID_BURNED_OUT_WHY_Q3.85t	 
HYBRID_BURNED_OUT_WHY_Q3.88t	If they are in the same path the burned out bulb affects the other bulb that means It depends on whether or not, they are in the same path.
HYBRID_BURNED_OUT_WHY_Q3.89t	 
VOLTAGE_DIFF_DISCUSS_1_Q.90t	The terminals are in the same state or connected that means, there is no gap between the terminals  "
VOLTAGE_DIFF_DISCUSS_1_Q.92t	there is no gap between the terminals
VOLTAGE_DIFF_DISCUSS_1_Q.95t	The terminals are in the same state or connected that means, there is no gap between the terminals   "
VOLTAGE_DIFF_DISCUSS_1_Q.96t	there is no gap between the terminals
BURNED_BULB_LOCATE_EXPLAIN_Q.99t	Measuring voltage indicates the place where the electrical state changes due to a damaged bulb or due to a gap . It also indicates whether two terminals are separated by a gap or connected.
BURNED_BULB_LOCATE_EXPLAIN_Q.106t	Measuring voltage indicates the place where the electrical state changes due to a damaged bulb or due to a gap . It also indicates whether two terminals are separated by a gap or connected . A zero voltage means that the terminals are connected or there is no damaged bulb, as well as a non-zero voltage means that the terminals are not connected or the terminals are separated by a gap.
SHORT_CIRCUIT_X_Q.56t	the battery is damaged . there is a short circuit.
SHORT_CIRCUIT_X_Q.60t	 
CONDITIONS_FOR_BULB_TO_LIGHT.100t	One terminal of the bulb has to be connected to one terminal of the battery, and the other terminal of the bulb has to be connected to the different terminal of the battery . There is a closed path containing both the bulb and a battery in a complete circuit.
CONDITIONS_FOR_BULB_TO_LIGHT.102t	One terminal of the bulb has to be connected to one terminal of the battery, and the other terminal of the bulb has to be connected to the different terminal of the battery"
CONDITIONS_FOR_BULB_TO_LIGHT.103t	One terminal of the bulb has to be connected to one terminal of the battery, and the other terminal of the bulb has to be connected to the different terminal of the battery . There is a closed path containing both the bulb and a battery in a complete circuit.
CONDITIONS_FOR_BULB_TO_LIGHT.107t	there is a closed path containing both the bulb and a battery in a complete circuit.
VOLTAGE_AND_GAP_DISCUSS_Q.70t	the terminals are separated by a gap or the bulb is damaged
VOLTAGE_AND_GAP_DISCUSS_Q.78t	the terminals are separated by a gap or the bulb is damaged
VOLTAGE_AND_GAP_DISCUSS_Q.79t	the terminals are separated by a gap or the bulb is damaged
VOLTAGE_AND_GAP_DISCUSS_Q.82t	the terminals are separated by a gap or the bulb is damaged
SWITCH_TABLE_EXPLAIN_Q3.77t	When the switch and the bulb are contained in the same path
SWITCH_TABLE_EXPLAIN_Q3.81t	When the switch and the bulb are contained in the same path
SWITCH_TABLE_EXPLAIN_Q3.85t	When the switch and the bulb are contained in the same path
PARALLEL_SWITCH_EXPLAIN_Q3.72t	If a bulb and a switch are in the same path the switch affects the bulb
PARALLEL_SWITCH_EXPLAIN_Q3.90t	If a bulb and a switch are in the same path the switch affects the bulb
PARALLEL_SWITCH_EXPLAIN_Q3.92t	If a bulb and a switch are in the same path the switch affects the bulb
PARALLEL_SWITCH_EXPLAIN_Q3.103t	If a bulb and a switch are in the same path the switch affects the bulb
PARALLEL_SWITCH_EXPLAIN_Q3.104t	If a bulb and a switch are in the same path the switch affects the bulb
VOLTAGE_DIFF_DISCUSS_2_Q.1a	 
VOLTAGE_DIFF_DISCUSS_2_Q.2a	 
VOLTAGE_DIFF_DISCUSS_2_Q.4a	 
DAMAGED_BULB_EXPLAIN_2_Q.1a	 
DAMAGED_BULB_EXPLAIN_2_Q.2a	 
DAMAGED_BULB_EXPLAIN_2_Q.3a	 
DAMAGED_BULB_EXPLAIN_2_Q.4a	 
HYBRID_BURNED_OUT_WHY_Q3.1a	 
HYBRID_BURNED_OUT_WHY_Q3.2a	 
HYBRID_BURNED_OUT_WHY_Q3.3a	If they are in the same path the burned out bulb affects the other bulb
VOLTAGE_DIFF_DISCUSS_1_Q.2a	 
VOLTAGE_DIFF_DISCUSS_1_Q.3a	The terminals are in the same state
VOLTAGE_DIFF_DISCUSS_1_Q.4a	The terminals are in the same state
VOLTAGE_DIFF_DISCUSS_1_Q.5a	 
VOLTAGE_DIFF_DISCUSS_1_Q.7a	 
VOLTAGE_DIFF_DISCUSS_1_Q.8a	 
VOLTAGE_DIFF_DISCUSS_1_Q.9a	 
BURNED_BULB_LOCATE_EXPLAIN_Q.1a	The place where the electrical state changes due to a gap
BURNED_BULB_LOCATE_EXPLAIN_Q.2a	Electrical state changes due to a gap
BURNED_BULB_LOCATE_EXPLAIN_Q.3a	 
BURNED_BULB_LOCATE_EXPLAIN_Q.4a	Non-zero voltage means that there is a gap
BURNED_BULB_LOCATE_EXPLAIN_Q.7a	The place where the electrical state changes due to a damaged bulb .
SHORT_CIRCUIT_X_Q.1a	 
SHORT_CIRCUIT_X_Q.2a	 
SHORT_CIRCUIT_X_Q.3a	The battery is damaged
SHORT_CIRCUIT_X_Q.4a	 
SHORT_CIRCUIT_X_Q.5a	 
SHORT_CIRCUIT_X_Q.6a	 
SHORT_CIRCUIT_X_Q.7a	 
SHORT_CIRCUIT_X_Q.8a	 
CONDITIONS_FOR_BULB_TO_LIGHT.1a	 
CONDITIONS_FOR_BULB_TO_LIGHT.2a	One terminal of the bulb has to be connected to one terminal of the battery , and the other terminal of the bulb has to be connected to the different terminal of the battery .
CONDITIONS_FOR_BULB_TO_LIGHT.3a	One terminal of the bulb has to be connected to one terminal of the battery , and the other terminal of the bulb has to be connected to the different terminal of the battery .
CONDITIONS_FOR_BULB_TO_LIGHT.4a	 
CONDITIONS_FOR_BULB_TO_LIGHT.5a	The circuit has a closed path
CONDITIONS_FOR_BULB_TO_LIGHT.6a	 
CONDITIONS_FOR_BULB_TO_LIGHT.7a	 
CONDITIONS_FOR_BULB_TO_LIGHT.8a	 
CONDITIONS_FOR_BULB_TO_LIGHT.9a	 
CONDITIONS_FOR_BULB_TO_LIGHT.10a	Are in a closed path
VOLTAGE_AND_GAP_DISCUSS_Q.2a	 
VOLTAGE_AND_GAP_DISCUSS_Q.3a	 
VOLTAGE_AND_GAP_DISCUSS_Q.4a	The terminals are not connected
SWITCH_TABLE_EXPLAIN_Q3.1a	 
SWITCH_TABLE_EXPLAIN_Q3.2a	When the switch and the bulb are contained in the same path
SWITCH_TABLE_EXPLAIN_Q3.3a	The switch and the bulb are contained in the same path
SWITCH_TABLE_EXPLAIN_Q3.4a	 
SWITCH_TABLE_EXPLAIN_Q3.5a	 
SWITCH_TABLE_EXPLAIN_Q3.6a	When the switch and the bulb are contained in the same path
SWITCH_TABLE_EXPLAIN_Q3.7a	 
SWITCH_TABLE_EXPLAIN_Q3.8a	Switch and the bulb are contained in the same path
SWITCH_TABLE_EXPLAIN_Q3.9a	 
SWITCH_TABLE_EXPLAIN_Q3.10a	When the switch and the bulb are contained in the same path
PARALLEL_SWITCH_EXPLAIN_Q3.1a	 
PARALLEL_SWITCH_EXPLAIN_Q3.2a	 
PARALLEL_SWITCH_EXPLAIN_Q3.3a	Switch and the bulb have to be in the same path
PARALLEL_SWITCH_EXPLAIN_Q3.4a	 
PARALLEL_SWITCH_EXPLAIN_Q3.5a	If a bulb and a switch are in the same path the switch affects the bulb
PARALLEL_SWITCH_EXPLAIN_Q3.6a	Switch and the bulb have to be in the same path
PARALLEL_SWITCH_EXPLAIN_Q3.7a	If a bulb and a switch are in the same path the switch affects the bulb
PARALLEL_SWITCH_EXPLAIN_Q3.8a	If a bulb and a switch are in the same path the switch affects the bulb
PARALLEL_SWITCH_EXPLAIN_Q3.9a	 
PARALLEL_SWITCH_EXPLAIN_Q3.10a	If a bulb and a switch are in the same path
PARALLEL_SWITCH_EXPLAIN_Q3.11a	The switch and the bulb have to be in the same path
VOLTAGE_DIFF_DISCUSS_2_Q.6a	The terminals are not connected
VOLTAGE_DIFF_DISCUSS_2_Q.7a	The terminals are not connected
VOLTAGE_DIFF_DISCUSS_2_Q.9a	The terminals are separated
DAMAGED_BULB_EXPLAIN_2_Q.5a	A damaged bulb creates a gap in the circuit . There is no closed path but an incomplete circuit.
HYBRID_BURNED_OUT_WHY_Q3.4a	The damaged bulb and the other bulb must be contained in the same path
HYBRID_BURNED_OUT_WHY_Q3.5a	If they are in the same path the burned out bulb affects the other bulb
VOLTAGE_DIFF_DISCUSS_1_Q.10a	There is no gap between the terminals
VOLTAGE_DIFF_DISCUSS_1_Q.11a	The terminals are not separated by a gap
VOLTAGE_DIFF_DISCUSS_1_Q.12a	The terminals are in the same state
VOLTAGE_DIFF_DISCUSS_1_Q.13a	The terminals are connected
VOLTAGE_DIFF_DISCUSS_1_Q.14a	The terminals are in the same state
VOLTAGE_DIFF_DISCUSS_1_Q.15a	The terminals are connected
VOLTAGE_DIFF_DISCUSS_1_Q.16a	The terminals are connected
VOLTAGE_DIFF_DISCUSS_1_Q.17a	The terminals are not separated by a gap
VOLTAGE_DIFF_DISCUSS_1_Q.18a	There is no gap between the terminals
BURNED_BULB_LOCATE_EXPLAIN_Q.8a	Measuring voltage indicates the place where the electrical state changes due to a gap
BURNED_BULB_LOCATE_EXPLAIN_Q.9a	Whether two terminals are connected to each other
BURNED_BULB_LOCATE_EXPLAIN_Q.10a	A non-zero voltage means that the terminals are not connected or they are separated by a gap . A non-zero voltage means there is a damaged bulb . A non-zero voltage means that there is a gap and the terminals have different electrical states.
SHORT_CIRCUIT_X_Q.9a	The battery is damaged.
SHORT_CIRCUIT_X_Q.10a	The battery is damaged.
SHORT_CIRCUIT_X_Q.11a	There is a short circuit.
CONDITIONS_FOR_BULB_TO_LIGHT.11a	There is a closed path containing both the bulb and a battery . There is a complete circuit . One terminal of the bulb has to be connected to one terminal of the battery, and the other terminal of the bulb has to be connected to the different terminal of the battery.
VOLTAGE_AND_GAP_DISCUSS_Q.6a	The terminals are not connected
VOLTAGE_AND_GAP_DISCUSS_Q.7a	The terminals are not connected
SWITCH_TABLE_EXPLAIN_Q3.11a	When the switch and the bulb are contained in the same path
PARALLEL_SWITCH_EXPLAIN_Q3.12a	If a bulb and a switch are in the same path the switch affects the bulb
PARALLEL_SWITCH_EXPLAIN_Q3.13a	If a bulb and a switch are in the same path the switch affects the bulb
PARALLEL_SWITCH_EXPLAIN_Q3.14a	The switch and the bulb have to be in the same path
PARALLEL_SWITCH_EXPLAIN_Q3.15a	If a bulb and a switch are in the same path the switch affects the bulb
PARALLEL_SWITCH_EXPLAIN_Q3.16a	The switch and the bulb have to be in the same path
PARALLEL_SWITCH_EXPLAIN_Q3.17a	If a bulb and a switch are in the same path the switch affects the bulb
VOLTAGE_ELECTRICAL_STATE_DISCUSS_Q.8q	Voltage is the difference in electrical states between two terminals
VOLTAGE_ELECTRICAL_STATE_DISCUSS_Q.9q	 
VOLTAGE_ELECTRICAL_STATE_DISCUSS_Q.13q	in electrical states
VOLTAGE_ELECTRICAL_STATE_DISCUSS_Q.15q	 
VOLTAGE_ELECTRICAL_STATE_DISCUSS_Q.18q	whether two terminals have different electrical states .
VOLTAGE_ELECTRICAL_STATE_DISCUSS_Q.22q	 
VOLTAGE_ELECTRICAL_STATE_DISCUSS_Q.24q	 
VOLTAGE_ELECTRICAL_STATE_DISCUSS_Q.25q	whether two terminals have different electrical states.
VOLTAGE_ELECTRICAL_STATE_DISCUSS_Q.26q	Measuring voltage indicates whether two terminals have different electrical states.
VOLTAGE_ELECTRICAL_STATE_DISCUSS_Q.46q	 
VOLTAGE_ELECTRICAL_STATE_DISCUSS_Q.47q	Measuring voltage indicates whether two terminals have different electrical states .
VOLTAGE_ELECTRICAL_STATE_DISCUSS_Q.50q	in electrical states
VOLTAGE_ELECTRICAL_STATE_DISCUSS_Q.51q	 
VOLTAGE_ELECTRICAL_STATE_DISCUSS_Q.52q	 
VOLTAGE_ELECTRICAL_STATE_DISCUSS_Q.53q	 
VOLTAGE_ELECTRICAL_STATE_DISCUSS_Q.58q	Voltage is the difference in electrical states between two terminals
VOLTAGE_ELECTRICAL_STATE_DISCUSS_Q.59q	 
VOLTAGE_ELECTRICAL_STATE_DISCUSS_Q.60q	in electrical states
VOLTAGE_ELECTRICAL_STATE_DISCUSS_Q.61q	 
VOLTAGE_ELECTRICAL_STATE_DISCUSS_Q.64q	 
VOLTAGE_ELECTRICAL_STATE_DISCUSS_Q.68q	 
DESCRIBE_GAP_LOCATE_PROCEDURE_Q.1q	 
DESCRIBE_GAP_LOCATE_PROCEDURE_Q.2q	 
DESCRIBE_GAP_LOCATE_PROCEDURE_Q.5q	 
DESCRIBE_GAP_LOCATE_PROCEDURE_Q.6q	 
DESCRIBE_GAP_LOCATE_PROCEDURE_Q.7q	When there is a change in voltage you have found the damaged bulb
DESCRIBE_GAP_LOCATE_PROCEDURE_Q.9q	 
DESCRIBE_GAP_LOCATE_PROCEDURE_Q.11q	 
DESCRIBE_GAP_LOCATE_PROCEDURE_Q.13q	 
DESCRIBE_GAP_LOCATE_PROCEDURE_Q.18q	When there is a change in voltage you have found the damaged bulb
DESCRIBE_GAP_LOCATE_PROCEDURE_Q.19q	 
DESCRIBE_GAP_LOCATE_PROCEDURE_Q.20q	 
DESCRIBE_GAP_LOCATE_PROCEDURE_Q.21q	 
DESCRIBE_GAP_LOCATE_PROCEDURE_Q.23q	 
DESCRIBE_GAP_LOCATE_PROCEDURE_Q.25q	 
DESCRIBE_GAP_LOCATE_PROCEDURE_Q.27q	 
DESCRIBE_GAP_LOCATE_PROCEDURE_Q.30q	 
DESCRIBE_GAP_LOCATE_PROCEDURE_Q.31q	 
DESCRIBE_GAP_LOCATE_PROCEDURE_Q.32q	 
DESCRIBE_GAP_LOCATE_PROCEDURE_Q.45q	 
DESCRIBE_GAP_LOCATE_PROCEDURE_Q.46q	 
DESCRIBE_GAP_LOCATE_PROCEDURE_Q.49q	 
DESCRIBE_GAP_LOCATE_PROCEDURE_Q.52q	 
DESCRIBE_GAP_LOCATE_PROCEDURE_Q.53q	 
DESCRIBE_GAP_LOCATE_PROCEDURE_Q.54q	 
DESCRIBE_GAP_LOCATE_PROCEDURE_Q.56q	When there is a change in voltage you have found the damaged bulb
DESCRIBE_GAP_LOCATE_PROCEDURE_Q.57q	 
DESCRIBE_GAP_LOCATE_PROCEDURE_Q.63q	 
DESCRIBE_GAP_LOCATE_PROCEDURE_Q.64q	 
DESCRIBE_GAP_LOCATE_PROCEDURE_Q.65q	When there is a change in voltage you have found the damaged bulb
DAMAGED_BULB_SWITCH_Q.4q	 
DAMAGED_BULB_SWITCH_Q.5q	 
DAMAGED_BULB_SWITCH_Q.7q	a damaged bulb and an open switch create a gap
DAMAGED_BULB_SWITCH_Q.9q	a damaged bulb and an open switch create a gap
DAMAGED_BULB_SWITCH_Q.14q	 
DAMAGED_BULB_SWITCH_Q.17q	 
DAMAGED_BULB_SWITCH_Q.19q	 
DAMAGED_BULB_SWITCH_Q.29q	 
DAMAGED_BULB_SWITCH_Q.34q	 
DAMAGED_BULB_SWITCH_Q.38q	 
DAMAGED_BULB_SWITCH_Q.44q	 
DAMAGED_BULB_SWITCH_Q.47q	 
DAMAGED_BULB_SWITCH_Q.53q	 
DAMAGED_BULB_SWITCH_Q.59q	 
DAMAGED_BULB_SWITCH_Q.60q	 
DAMAGED_BULB_SWITCH_Q.61q	 
DAMAGED_BULB_SWITCH_Q.82q	 
DAMAGED_BULB_SWITCH_Q.83q	 
DAMAGED_BULB_SWITCH_Q.84q	 
VOLTAGE_ELECTRICAL_STATE_DISCUSS_Q.71q	Measuring voltage indicates whether two terminals have different electrical states . With a zero voltage and a non-zero voltage means that the terminals have the same and different electrical state respectively.
VOLTAGE_ELECTRICAL_STATE_DISCUSS_Q.77q	Measuring voltage indicates whether two terminals have different electrical states
VOLTAGE_ELECTRICAL_STATE_DISCUSS_Q.79q	Measuring voltage indicates whether two terminals have different electrical states . With a zero voltage and a non-zero voltage means that the terminals have the same and different electrical state respectively.
VOLTAGE_ELECTRICAL_STATE_DISCUSS_Q.80q	Measuring voltage indicates whether two terminals have different electrical states
VOLTAGE_ELECTRICAL_STATE_DISCUSS_Q.82q	Measuring voltage indicates whether two terminals have different electrical states . With a zero voltage and a non-zero voltage means that the terminals have the same and different electrical state respectively.
VOLTAGE_ELECTRICAL_STATE_DISCUSS_Q.88q	Measuring voltage indicates whether two terminals have different electrical states . With a zero voltage and a non-zero voltage means that the terminals have the same and different electrical state respectively.
VOLTAGE_ELECTRICAL_STATE_DISCUSS_Q.91q	Measuring voltage indicates whether two terminals have different electrical states
VOLTAGE_ELECTRICAL_STATE_DISCUSS_Q.94q	Measuring voltage indicates whether two terminals have different electrical states . With a zero voltage and a non-zero voltage means that the terminals have the same and different electrical state respectively.
VOLTAGE_ELECTRICAL_STATE_DISCUSS_Q.95q	a zero voltage and a non-zero voltage means that the terminals have the same and different electrical state respectively.
VOLTAGE_ELECTRICAL_STATE_DISCUSS_Q.100q	Measuring voltage indicates whether two terminals have different electrical states . With a zero voltage and a non-zero voltage means that the terminals have the same and different electrical state respectively
VOLTAGE_ELECTRICAL_STATE_DISCUSS_Q.107q	Measuring voltage indicates whether two terminals have different electrical states with a zero voltage and a non-zero voltage means that the terminals have the same  and different electrical state respectively
VOLTAGE_ELECTRICAL_STATE_DISCUSS_Q.111q	a zero voltage and a non-zero voltage means that the terminals have the same and different electrical state respectively
VOLTAGE_ELECTRICAL_STATE_DISCUSS_Q.113q	Measuring voltage indicates whether two terminals have different electrical states
VOLTAGE_ELECTRICAL_STATE_DISCUSS_Q.128q	a zero voltage and a non-zero voltage means that the terminals have the same and different electrical state respectively
VOLTAGE_ELECTRICAL_STATE_DISCUSS_Q.129q	Measuring voltage indicates whether two terminals have different electrical states
VOLTAGE_ELECTRICAL_STATE_DISCUSS_Q.134q	a zero voltage and a non-zero voltage means that the terminals have the same and different electrical state respectively
DESCRIBE_GAP_LOCATE_PROCEDURE_Q.85q	When there is a change in voltage or the bulb with non-zero voltage reading between two terminals you have found the damaged bulb
DESCRIBE_GAP_LOCATE_PROCEDURE_Q.86q	When there is a change in voltage or the bulb with non-zero voltage reading between two terminals you have found the damaged bulb
DESCRIBE_GAP_LOCATE_PROCEDURE_Q.91q	When there is a change in voltage or the bulb with non-zero voltage reading between two terminals you have found the damaged bulb
DESCRIBE_GAP_LOCATE_PROCEDURE_Q.92q	When there is a change in voltage or the bulb with non-zero voltage reading between two terminals you have found the damaged bulb
DESCRIBE_GAP_LOCATE_PROCEDURE_Q.96q	 
DESCRIBE_GAP_LOCATE_PROCEDURE_Q.98q	the bulb with non-zero voltage reading between two terminals you have found the damaged bulb
DESCRIBE_GAP_LOCATE_PROCEDURE_Q.99q	the bulb with non-zero voltage reading between two terminals you have found the damaged bulb
DESCRIBE_GAP_LOCATE_PROCEDURE_Q.102q	When there is a change in voltage or a non-zero voltage reading between two terminals you have found the damaged bulb
DESCRIBE_GAP_LOCATE_PROCEDURE_Q.104q	When there is a change in voltage or a non-zero voltage reading between two terminals you have found the damaged bulb
DESCRIBE_GAP_LOCATE_PROCEDURE_Q.105q	When there is a change in voltage or a non-zero voltage reading between two terminals you have found the damaged bulb
DESCRIBE_GAP_LOCATE_PROCEDURE_Q.106q	When there is a change in voltage or a non-zero voltage reading between two terminals you have found the damaged bulb
DAMAGED_BULB_SWITCH_Q.87q	A damaged bulb and an open switch both create a gap and cause bulbs to go out
DAMAGED_BULB_SWITCH_Q.89q	they do the same thing
DAMAGED_BULB_SWITCH_Q.92q	 
VOLTAGE_ELECTRICAL_STATE_DISCUSS_Q.1q	 
VOLTAGE_ELECTRICAL_STATE_DISCUSS_Q.5q	 
DAMAGED_BULB_SWITCH_Q.80q	 
VOLTAGE_DEFINE_Q.57t	The difference in electrical states between two terminals
VOLTAGE_DEFINE_Q.68t	The difference in electrical states between two terminals
VOLTAGE_DEFINE_Q.73t	 
VOLTAGE_DEFINE_Q.78t	The difference in electrical states between two terminals
VOLTAGE_DEFINE_Q.80t	The difference in electrical states between two terminals
VOLTAGE_DEFINE_Q.102t	The difference in electrical states between two terminals
VOLTAGE_DEFINE_Q.104t	The difference in electrical states between two terminals
VOLTAGE_DEFINE_Q.106t	The difference in electrical states between two terminals
VOLTAGE_DEFINE_Q.1a	The difference in electrical states between two terminals
VOLTAGE_DEFINE_Q.2a	The difference in electrical states between two terminals
VOLTAGE_DEFINE_Q.3a	 
VOLTAGE_DEFINE_Q.4a	The difference in electrical states between two terminals
VOLTAGE_DEFINE_Q.7a	The difference in electrical states between two terminals
VOLTAGE_DEFINE_Q.9a	 
VOLTAGE_DEFINE_Q.10a	 
VOLTAGE_DEFINE_Q.11a	The difference in electrical states between two terminals
VOLTAGE_DEFINE_Q.13a	The difference in electrical states between two terminals
VOLTAGE_DEFINE_Q.1t	The difference in electrical states between two terminals
VOLTAGE_DEFINE_Q.4t	 
VOLTAGE_DEFINE_Q.5t	 
VOLTAGE_DEFINE_Q.6t	 
VOLTAGE_DEFINE_Q.7t	 
VOLTAGE_DEFINE_Q.9t	The difference in electrical states between two terminals
VOLTAGE_DEFINE_Q.10t	 
VOLTAGE_DEFINE_Q.11t	 
VOLTAGE_DEFINE_Q.12t	 
VOLTAGE_DEFINE_Q.13t	 
VOLTAGE_DEFINE_Q.14t	The difference in electrical states between two terminals
VOLTAGE_DEFINE_Q.15t	The difference in electrical states between two terminals
VOLTAGE_DEFINE_Q.16t	The difference in electrical states between two terminals
VOLTAGE_DEFINE_Q.17t	 
VOLTAGE_DEFINE_Q.18t	 
VOLTAGE_DEFINE_Q.19t	The difference in electrical states between two terminals
VOLTAGE_DEFINE_Q.20t	The difference in electrical states between two terminals
VOLTAGE_DEFINE_Q.21t	 
VOLTAGE_DEFINE_Q.22t	 
VOLTAGE_DEFINE_Q.23t	The difference in electrical states between two terminals
VOLTAGE_DEFINE_Q.24t	The difference in electrical states between two terminals
VOLTAGE_DEFINE_Q.25t	The difference in electrical states between two terminals
VOLTAGE_DEFINE_Q.26t	The difference in electrical states between two terminals
VOLTAGE_DEFINE_Q.27t	The difference in electrical states between two terminals
VOLTAGE_DEFINE_Q.28t	 
VOLTAGE_DEFINE_Q.29t	The difference in electrical states between two terminals
VOLTAGE_DEFINE_Q.30t	The difference in electrical states between two terminals
VOLTAGE_DEFINE_Q.31t	 
VOLTAGE_DEFINE_Q.32t	The difference in electrical states between two terminals
VOLTAGE_DEFINE_Q.33t	The difference in electrical states between two terminals
VOLTAGE_DEFINE_Q.34t	The difference in electrical states between two terminals
VOLTAGE_DEFINE_Q.35t	The difference in electrical states between two terminals
VOLTAGE_DEFINE_Q.36t	The difference in electrical states between two terminals
VOLTAGE_DEFINE_Q.37t	 
VOLTAGE_DEFINE_Q.38t	 
VOLTAGE_DEFINE_Q.39t	The difference in electrical states between two terminals
VOLTAGE_DEFINE_Q.40t	The difference in electrical states between two terminals
VOLTAGE_DEFINE_Q.41t	 
VOLTAGE_DEFINE_Q.42t	 
VOLTAGE_DEFINE_Q.43t	The difference in electrical states between two terminals
VOLTAGE_DEFINE_Q.5a	The difference in electrical states between two terminals
VOLTAGE_DEFINE_Q.6a	The difference in electrical states between two terminals
VOLTAGE_DEFINE_Q.8a	The difference in electrical states between two terminals
VOLTAGE_DEFINE_Q.12a	The difference in electrical states between two terminals
